Язык Си = Язык программирования Си
АиСД = Алгоритмы и структуры данных
Ин.яз. (русский) = Иностранный язык (русский)
Ин.яз. = Иностранный язык
МЛ и ТА = Математическая логика и теория алгоритмов
Архитектура ВС = Архитектура вычислительных систем
АСВТ = Аппаратные средства вычислительной техники
МиО = Микроэлектроника и оптоэлектроника
ДМ = Дискретная математика
ТФКП = Теория функций комплексного переменного
СПЭД и офисное программирование = Системы подготовки электронных документов и офисное программирование
Пр. на ЭВМ = Практика на ЭВМ
ЯиСП = Языки и системы программирования
УрМат = Уравнения математической физики
УрМат и СФ = Уравнения математической физики и специальные функции
Проектирование ЧМИ = Проектирование человеко-машинного интерфейса
ПППдляНИ = Пакет прикладных программ для научных исследований
ОиПОИБ = Организационное и правовое обеспечение информационной безопасности
МБКС = Модели безопасности компьютерных систем
ТВиМС = Теория вероятностей и математическая статистика
СиАКОД = Структуры и алгоритмы компьютерной обработки данных
Практикум СиАКОД = Практикум структуры и алгоритмы компьютерной обработки данных
ИТ бух.уч. = Информационные технологии бухгалтерского учета
ИСиС = Инфокоммуникационные системы и сети
КТ = КТ
ИПС = ИПС
ИСвАТ = ИСвАТ
ПАОД = ПАОД
ТП = Технологии программирования
ИТ = Информационные технологии
Техн. интернет вещей = Технологии интернет вещей
НСТОИ = НСТОИ
ЯП Java = Язык программирования Java
ЯП Python = Язык программирования Python
ЗИ от утечки по ТК = Защита информации от утечки по техническим каналам
СЦВЗ = СЦВЗ
СиСПИ = Сети и системы передачи информации
МиСОЗКС = Методы и стандарты оценки защищенности компьютерных систем
ИНСиГА = Искусственные нейронные сети и генетические алгоритмы
ФИТ = ФИТ
РО = Распознавание образов
МС = Моделирование систем
ТЗОиБ = Технологии защищенного документооборота и блокчейн (ТЗОиБ)
АУТПИПЭ = Автоматизированное управление технологическими процессами изготовления полупроводниковой электроники
КОЗИОИ = Комплексное обеспечение защиты информации объекта информатизации
АУиЗПО = АУиЗПО
ОТУ = Основы теории управления
СиСТК = Сети и системы телекоммуникаций (СиСТК)
АУПО = Анализ уязвимостей программного обеспечения